********
**P*****
G*******
*******D
P****P**
D*P*****
********
*D******
40
10
-15
8 8
