*P******
********
********
P*****D*
*****D**
********
*P**PDG*
********
40
10
-15
8 8
