********
********
**P*****
*P*P****
D****P**
********
*D*D****
****G***
40
10
-15
8 8
