********
**D*****
*DP*P*P*
*******G
********
*****P**
*******D
********
40
10
-15
8 8
