********
***P**D*
********
***D****
********
*****GW*
*W******
***D****
40
10
-15
8 8
