********
********
***D****
***P****
****D***
****W***
*D**W***
**G*****
40
10
-15
8 8
