*****P*G
********
********
***D****
D**W****
***D****
***W****
********
40
10
-15
8 8
