*******W
D*D*****
D*******
******WP
********
********
G*******
********
40
10
-15
8 8
