*G*****G
*P*W****
**DD****
********
********
********
****G***
***P****
45
10
-15
8 8
