**W*****
*D**P*D*
********
****G***
******G*
P**G****
********
********
45
10
-15
8 8
