**W*****
**P*****
******P*
G**G*D**
********
********
*****D**
*G******
45
10
-15
8 8
