********
D*G***P*
*******W
***G****
********
*DP*****
********
*G******
45
10
-15
8 8
