********
********
D*******
********
***D*P**
*G*****D
**PP*W*D
*******G
30
10
-15
8 8
