********
*****P**
********
**D*D***
********
***D***D
*P*GW***
P*****G*
30
10
-15
8 8
