**D*****
*P*****G
D**P**D*
*****D**
****G**W
********
****P***
********
30
10
-15
8 8
