********
********
*P*****D
D*******
*GD**P**
********
***G*D**
**P**W**
30
10
-15
8 8
